Rk,Player,Pos,Age,Tm,G,GS,MP,FG,FGA,FG%,3P,3PA,3P%,2P,2PA,2P%,eFG%,FT,FTA,FT%,ORB,DRB,TRB,AST,STL,BLK,TOV,PF,PTS
1,Precious Achiuwa,C,22,TOR,68,27,1602,247,559,0.442,49,136,0.36,198,423,0.468,0.486,70,117,0.598,142,316,458,77,34,38,75,143,613
2,Steven Adams,C,28,MEM,73,72,1925,206,376,0.548,0,1,0,206,375,0.549,0.548,107,193,0.554,340,388,728,239,63,58,109,144,519
3,Bam Adebayo,C,24,MIA,53,53,1726,385,693,0.556,0,6,0,385,687,0.56,0.556,236,312,0.756,131,409,540,182,77,43,144,164,1006
4,Santi Aldama,PF,21,MEM,30,0,319,43,109,0.394,4,41,0.098,39,68,0.574,0.413,14,24,0.583,25,47,72,16,3,10,11,32,104
5,LaMarcus Aldridge,C,36,BRK,45,12,1027,252,455,0.554,14,45,0.311,238,410,0.58,0.569,89,102,0.873,71,181,252,41,14,46,42,74,607
6,Nickeil Alexander-Walker,SG,23,TOT,63,21,1446,249,673,0.37,102,332,0.307,147,341,0.431,0.446,80,108,0.741,37,147,184,152,45,23,93,101,680
6,Nickeil Alexander-Walker,SG,23,NOP,50,19,1317,237,632,0.375,95,305,0.311,142,327,0.434,0.45,70,97,0.722,36,128,164,139,41,19,85,88,639
6,Nickeil Alexander-Walker,SG,23,UTA,13,2,129,12,41,0.293,7,27,0.259,5,14,0.357,0.378,10,11,0.909,1,19,20,13,4,4,8,13,41
7,Grayson Allen,SG,26,MIL,64,61,1757,248,557,0.445,156,382,0.408,92,175,0.526,0.585,60,70,0.857,31,186,217,96,45,16,42,95,712
8,Jarrett Allen,C,23,CLE,56,56,1809,369,545,0.677,1,10,0.1,368,535,0.688,0.678,165,233,0.708,192,410,602,92,44,75,94,97,904
9,Jose Alvarado,PG,23,NOP,49,1,744,116,261,0.444,31,99,0.313,85,162,0.525,0.504,32,45,0.711,23,68,91,134,63,7,35,70,295
10,Justin Anderson,SF,28,TOT,14,6,294,36,89,0.404,15,55,0.273,21,34,0.618,0.489,15,19,0.789,4,41,45,30,8,3,8,22,102
10,Justin Anderson,SF,28,CLE,3,0,47,4,8,0.5,2,6,0.333,2,2,1,0.625,3,4,0.75,0,6,6,6,1,0,2,4,13
10,Justin Anderson,SF,28,IND,11,6,247,32,81,0.395,13,49,0.265,19,32,0.594,0.475,12,15,0.8,4,35,39,24,7,3,6,18,89
11,Kyle Anderson,PF,28,MEM,65,10,1397,193,440,0.439,32,101,0.317,161,339,0.475,0.475,61,97,0.629,67,283,350,170,73,41,66,99,479
12,Giannis Antetokounmpo,PF,27,MIL,63,63,2075,650,1173,0.554,69,230,0.3,581,943,0.616,0.584,528,730,0.723,126,609,735,366,66,90,209,202,1897
13,Thanasis Antetokounmpo,SF,29,MIL,45,5,423,57,109,0.523,1,11,0.091,56,98,0.571,0.528,21,36,0.583,40,56,96,19,15,11,21,64,136
14,Carmelo Anthony,PF,37,LAL,67,3,1744,308,695,0.443,146,384,0.38,162,311,0.521,0.548,130,157,0.828,61,219,280,64,45,51,58,160,892
15,Cole Anthony,PG,21,ORL,64,64,2057,357,911,0.392,132,391,0.338,225,520,0.433,0.464,216,253,0.854,32,316,348,369,46,17,170,170,1062
16,OG Anunoby,SF,24,TOR,47,47,1703,306,688,0.445,115,312,0.369,191,376,0.508,0.528,87,116,0.75,72,183,255,122,70,25,77,131,814
17,Ryan Arcidiacono,PG,27,NYK,7,0,39,4,6,0.667,3,4,0.75,1,2,0.5,0.917,0,0,,0,3,3,1,0,0,1,0,11
18,Trevor Ariza,SF,36,LAL,24,11,462,33,99,0.333,20,74,0.27,13,25,0.52,0.434,10,18,0.556,10,72,82,27,13,6,11,20,96
19,D.J. Augustin,PG,34,TOT,50,2,787,91,202,0.45,66,149,0.443,25,53,0.472,0.614,34,39,0.872,10,53,63,97,15,0,53,29,282
19,D.J. Augustin,PG,34,HOU,34,2,510,55,136,0.404,39,96,0.406,16,40,0.4,0.548,33,38,0.868,7,34,41,74,10,0,45,17,182
19,D.J. Augustin,PG,34,LAL,16,0,277,36,66,0.545,27,53,0.509,9,13,0.692,0.75,1,1,1,3,19,22,23,5,0,8,12,100
20,Deni Avdija,SF,21,WAS,77,6,1835,225,523,0.43,75,233,0.322,150,290,0.517,0.502,101,132,0.765,47,353,400,146,56,41,75,175,626
21,Joel Ayayi,SG,21,WAS,7,0,20,1,6,0.167,0,1,0,1,5,0.2,0.167,0,0,,1,2,3,4,0,0,0,0,2
22,Deandre Ayton,C,23,PHO,56,56,1652,423,665,0.636,6,17,0.353,417,648,0.644,0.641,104,140,0.743,141,429,570,78,39,37,89,134,956
23,Udoka Azubuike,C,22,UTA,17,6,195,37,49,0.755,0,0,,37,49,0.755,0.755,6,11,0.545,18,53,71,0,1,11,12,25,80
24,Marvin Bagley III,PF,22,TOT,48,25,1146,225,446,0.504,23,97,0.237,202,349,0.579,0.53,67,101,0.663,105,233,338,36,22,18,39,93,540
24,Marvin Bagley III,PF,22,SAC,30,17,656,114,246,0.463,15,62,0.242,99,184,0.538,0.494,35,47,0.745,67,148,215,17,9,11,21,50,278
24,Marvin Bagley III,PF,22,DET,18,8,490,111,200,0.555,8,35,0.229,103,165,0.624,0.575,32,54,0.593,38,85,123,19,13,7,18,43,262
25,LaMelo Ball,PG,20,CHO,71,71,2295,505,1188,0.425,201,530,0.379,304,658,0.462,0.51,205,236,0.869,104,369,473,530,113,30,225,227,1416
26,Lonzo Ball,PG,24,CHI,35,35,1212,162,383,0.423,110,260,0.423,52,123,0.423,0.567,21,28,0.75,35,155,190,178,64,31,82,85,455
27,Mo Bamba,C,23,ORL,67,65,1733,276,578,0.478,94,254,0.37,182,324,0.562,0.559,53,66,0.803,141,395,536,79,38,110,75,174,699
28,Desmond Bane,SF,23,MEM,73,73,2186,489,1062,0.46,219,509,0.43,270,553,0.488,0.564,132,147,0.898,44,280,324,203,84,29,106,183,1329
29,Dalano Banton,SF,22,TOR,63,1,691,83,202,0.411,13,51,0.255,70,151,0.464,0.443,25,42,0.595,38,85,123,98,27,10,53,67,204
30,Cat Barber,PG,27,ATL,3,0,13,0,4,0,0,0,,0,4,0,0,0,4,0,1,2,3,3,0,0,1,1,0
31,Harrison Barnes,PF,29,SAC,73,73,2483,378,802,0.471,140,344,0.407,238,458,0.52,0.559,334,404,0.827,78,332,410,183,52,14,116,92,1230
32,Scottie Barnes,PF,20,TOR,69,69,2451,429,873,0.491,52,174,0.299,377,699,0.539,0.521,150,204,0.735,183,337,520,244,76,55,130,179,1060
33,RJ Barrett,SF,21,NYK,67,67,2324,465,1137,0.409,133,384,0.346,332,753,0.441,0.467,275,382,0.72,64,329,393,193,42,16,145,139,1338
34,Will Barton,SG,31,DEN,68,68,2171,376,861,0.437,146,408,0.358,230,453,0.508,0.521,95,119,0.798,43,288,331,264,53,31,123,109,993
35,Paris Bass,SF,26,PHO,2,0,7,2,6,0.333,0,2,0,2,4,0.5,0.333,2,2,1,2,2,4,0,1,0,2,2,6
36,Charles Bassey,PF,21,PHI,23,0,168,30,47,0.638,0,4,0,30,43,0.698,0.638,9,12,0.75,22,40,62,7,5,17,8,32,69
37,Keita Bates-Diop,SF,26,SAS,54,13,859,113,225,0.502,17,51,0.333,96,174,0.552,0.54,41,56,0.732,53,155,208,38,26,14,38,56,284
38,Nicolas Batum,PF,33,LAC,56,51,1392,173,375,0.461,104,262,0.397,69,113,0.611,0.6,24,36,0.667,28,215,243,90,54,42,38,77,474
39,Kent Bazemore,SF,32,LAL,38,14,531,45,137,0.328,29,79,0.367,16,58,0.276,0.434,13,17,0.765,13,54,67,34,25,8,21,68,132
40,Darius Bazley,PF,21,OKC,69,53,1924,274,649,0.422,80,269,0.297,194,380,0.511,0.484,117,170,0.688,71,365,436,97,58,70,90,68,745
41,Bradley Beal,SG,28,WAS,40,40,1439,348,771,0.451,63,210,0.3,285,561,0.508,0.492,169,203,0.833,38,151,189,265,36,15,135,95,928
42,Malik Beasley,SG,25,MIN,75,14,1872,317,811,0.391,228,605,0.377,89,206,0.432,0.531,46,57,0.807,25,196,221,110,39,11,43,84,908
43,Jordan Bell,C,27,CHI,1,0,2,0,0,,0,0,,0,0,,,0,0,,1,0,1,0,1,0,0,2,0
44,DeAndre' Bembry,SF,27,TOT,56,20,1026,124,221,0.561,15,36,0.417,109,185,0.589,0.595,21,35,0.6,42,121,163,66,49,25,31,113,284
44,DeAndre' Bembry,SF,27,BRK,48,20,949,121,213,0.568,15,36,0.417,106,177,0.599,0.603,21,35,0.6,38,114,152,60,47,25,30,104,278
44,DeAndre' Bembry,SF,27,MIL,8,0,77,3,8,0.375,0,0,,3,8,0.375,0.375,0,0,,4,7,11,6,2,0,1,9,6
45,Dāvis Bertāns,PF,29,TOT,52,0,743,89,255,0.349,68,213,0.319,21,42,0.5,0.482,36,40,0.9,10,91,101,23,15,10,18,79,282
45,Dāvis Bertāns,PF,29,WAS,34,0,501,60,171,0.351,46,144,0.319,14,27,0.519,0.485,28,30,0.933,6,55,61,16,11,6,14,55,194
45,Dāvis Bertāns,PF,29,DAL,18,0,242,29,84,0.345,22,69,0.319,7,15,0.467,0.476,8,10,0.8,4,36,40,7,4,4,4,24,88
46,Patrick Beverley,PG,33,MIN,56,52,1433,173,425,0.407,82,236,0.347,91,189,0.481,0.504,92,127,0.724,61,173,234,256,66,50,72,168,520
47,Saddiq Bey,SF,22,DET,78,78,2602,429,1081,0.397,201,582,0.345,228,499,0.457,0.49,199,242,0.822,105,327,432,222,70,16,94,123,1258
48,Khem Birch,C,29,TOR,50,23,895,88,182,0.484,0,12,0,88,170,0.518,0.484,52,70,0.743,110,106,216,52,27,23,25,96,228
49,Goga Bitadze,C,22,IND,49,15,720,128,249,0.514,23,80,0.288,105,169,0.621,0.56,64,94,0.681,79,97,176,54,21,40,45,104,343
50,Bismack Biyombo,C,29,PHO,32,3,423,72,124,0.581,0,0,,72,124,0.581,0.581,31,62,0.5,57,82,139,18,11,22,24,62,175
51,Nemanja Bjelica,C,33,GSW,67,0,1058,144,317,0.454,49,139,0.353,95,178,0.534,0.532,52,74,0.703,54,213,267,141,37,24,80,122,389
52,Eric Bledsoe,PG,32,LAC,54,29,1361,197,468,0.421,51,163,0.313,146,305,0.479,0.475,89,117,0.761,28,154,182,225,69,19,116,85,534
53,Keljin Blevins,SF,26,POR,26,1,269,30,88,0.341,18,55,0.327,12,33,0.364,0.443,4,9,0.444,15,22,37,17,8,1,14,22,82
54,Bogdan Bogdanović,SG,29,ATL,59,27,1724,316,732,0.432,151,421,0.359,165,311,0.531,0.535,91,106,0.858,27,199,226,178,64,13,69,124,874
55,Bojan Bogdanović,PF,32,UTA,66,66,2033,404,886,0.456,173,447,0.387,231,439,0.526,0.554,206,240,0.858,56,224,280,117,29,1,112,108,1187
56,Bol Bol,PF,22,DEN,14,0,81,15,27,0.556,1,4,0.25,14,23,0.609,0.574,2,5,0.4,4,16,20,5,1,2,4,4,33
57,Leandro Bolmaro,SF,21,MIN,34,2,223,13,45,0.289,4,17,0.235,9,28,0.321,0.333,9,11,0.818,15,25,40,17,6,0,13,25,39
58,Isaac Bonga,SF,22,TOR,15,0,69,3,13,0.231,1,4,0.25,2,9,0.222,0.269,5,8,0.625,4,3,7,4,8,2,2,10,12
59,Devin Booker,SG,25,PHO,66,66,2277,637,1373,0.464,175,464,0.377,462,909,0.508,0.528,308,356,0.865,44,287,331,322,76,26,160,174,1757
60,Brandon Boston Jr.,SG,20,LAC,50,0,722,117,310,0.377,34,109,0.312,83,201,0.413,0.432,57,68,0.838,16,88,104,46,25,12,30,42,325
61,Chris Boucher,PF,29,TOR,75,9,1570,249,533,0.467,60,208,0.288,189,325,0.582,0.523,136,176,0.773,168,296,464,20,48,70,40,164,694
62,James Bouknight,SG,21,CHO,28,0,296,48,136,0.353,17,49,0.347,31,87,0.356,0.415,27,31,0.871,21,27,48,23,7,1,13,28,140
63,Avery Bradley,SG,31,LAL,60,43,1361,142,341,0.416,79,204,0.387,63,137,0.46,0.532,16,18,0.889,31,103,134,46,52,9,38,113,379
64,Tony Bradley,C,24,CHI,52,7,524,64,111,0.577,0,0,,64,111,0.577,0.577,17,25,0.68,60,115,175,26,10,32,30,58,145
65,Ignas Brazdeikis,SF,23,ORL,38,0,406,58,135,0.43,20,63,0.317,38,72,0.528,0.504,14,19,0.737,16,36,52,28,8,2,14,38,150
66,Mikal Bridges,SF,25,PHO,77,77,2736,436,815,0.535,113,300,0.377,323,515,0.627,0.604,122,148,0.824,73,260,333,178,92,36,64,145,1107
67,Miles Bridges,PF,23,CHO,76,76,2721,570,1162,0.491,146,445,0.328,424,717,0.591,0.553,256,321,0.798,88,449,537,288,72,65,147,189,1542
68,Oshae Brissett,SF,23,IND,63,21,1435,184,453,0.406,71,210,0.338,113,243,0.465,0.485,102,147,0.694,98,228,326,59,41,29,47,104,541
69,Malcolm Brogdon,PG,29,IND,36,36,1206,243,543,0.448,58,186,0.312,185,357,0.518,0.501,143,167,0.856,33,152,185,212,30,14,77,71,687
70,Armoni Brooks,SG-PG,23,TOT,51,9,806,97,281,0.345,73,241,0.303,24,40,0.6,0.475,16,19,0.842,19,78,97,59,27,11,26,69,283
70,Armoni Brooks,SG,23,HOU,41,8,690,87,251,0.347,64,213,0.3,23,38,0.605,0.474,16,19,0.842,12,69,81,49,21,8,23,60,254
70,Armoni Brooks,PG,23,TOR,10,1,116,10,30,0.333,9,28,0.321,1,2,0.5,0.483,0,0,,7,9,16,10,6,3,3,9,29
71,Dillon Brooks,SF,26,MEM,30,29,835,212,495,0.428,43,142,0.303,169,353,0.479,0.472,88,104,0.846,29,69,98,81,35,7,48,99,555
72,Bruce Brown,SF,25,BRK,68,41,1631,235,467,0.503,32,84,0.381,203,383,0.53,0.537,86,115,0.748,94,224,318,129,73,42,49,162,588
73,Charlie Brown Jr.,SG,24,TOT,22,2,177,10,39,0.256,1,12,0.083,9,27,0.333,0.269,9,10,0.9,14,18,32,6,10,4,5,18,30
73,Charlie Brown Jr.,SG,24,DAL,3,0,15,1,5,0.2,0,3,0,1,2,0.5,0.2,0,0,,0,1,1,1,2,1,0,2,2
73,Charlie Brown Jr.,SG,24,PHI,19,2,162,9,34,0.265,1,9,0.111,8,25,0.32,0.279,9,10,0.9,14,17,31,5,8,3,5,16,28
74,Chaundee Brown Jr.,SG-SF,23,TOT,5,2,104,10,32,0.313,6,18,0.333,4,14,0.286,0.406,5,6,0.833,1,15,16,4,2,0,1,7,31
74,Chaundee Brown Jr.,SF,23,LAL,2,0,21,1,7,0.143,0,3,0,1,4,0.25,0.143,0,0,,0,2,2,0,0,0,1,0,2
74,Chaundee Brown Jr.,SG,23,ATL,3,2,83,9,25,0.36,6,15,0.4,3,10,0.3,0.48,5,6,0.833,1,13,14,4,2,0,0,7,29
75,Greg Brown III,SF,20,POR,43,2,524,67,158,0.424,12,45,0.267,55,113,0.487,0.462,38,59,0.644,36,81,117,27,23,20,27,76,184
76,Jaylen Brown,SF,25,BOS,62,62,2097,538,1143,0.471,156,440,0.355,382,703,0.543,0.539,230,301,0.764,51,326,377,207,63,16,170,151,1462
77,Moses Brown,C,22,TOT,36,4,284,52,87,0.598,0,0,,52,87,0.598,0.598,38,62,0.613,30,79,109,1,6,15,16,43,142
77,Moses Brown,C,22,DAL,26,1,169,27,50,0.54,0,0,,27,50,0.54,0.54,27,43,0.628,16,45,61,1,3,9,14,28,81
77,Moses Brown,C,22,CLE,10,3,115,25,37,0.676,0,0,,25,37,0.676,0.676,11,19,0.579,14,34,48,0,3,6,2,15,61
78,Sterling Brown,SG,26,DAL,48,3,614,56,149,0.376,27,89,0.303,29,60,0.483,0.466,14,15,0.933,26,119,145,34,13,7,23,53,153
79,Troy Brown Jr.,SF,22,CHI,62,6,985,98,236,0.415,42,121,0.347,56,115,0.487,0.504,19,25,0.76,37,147,184,56,31,5,23,61,257
80,Jalen Brunson,PG,25,DAL,75,57,2406,483,962,0.502,86,234,0.368,397,728,0.545,0.547,167,199,0.839,41,250,291,366,64,3,122,146,1219
81,Thomas Bryant,C,24,WAS,24,9,401,75,141,0.532,12,40,0.3,63,101,0.624,0.574,35,40,0.875,26,66,92,23,6,18,18,41,197
82,Shaq Buchanan,PG,25,MEM,2,0,10,1,4,0.25,0,2,0,1,2,0.5,0.25,0,0,,1,1,2,2,1,0,2,1,2
83,Reggie Bullock,SF,30,DAL,64,33,1777,189,474,0.399,133,372,0.358,56,102,0.549,0.539,38,46,0.826,31,195,226,78,40,13,36,98,549
84,Trey Burke,PG,29,DAL,39,0,418,81,205,0.395,25,80,0.313,56,125,0.448,0.456,20,23,0.87,4,27,31,52,11,0,26,37,207
85,Alec Burks,SG,30,NYK,77,40,2175,267,691,0.386,147,370,0.397,120,321,0.374,0.493,204,247,0.826,44,329,373,219,81,25,80,198,885
86,Jared Butler,SG,21,UTA,39,1,304,55,131,0.42,26,75,0.347,29,56,0.518,0.519,7,12,0.583,5,31,36,50,13,7,31,43,143
87,Jimmy Butler,SF,32,MIA,55,55,1858,384,804,0.478,25,110,0.227,359,694,0.517,0.493,379,435,0.871,101,226,327,303,91,27,114,85,1172
88,Devontae Cacok,PF,25,SAS,11,0,92,18,26,0.692,0,0,,18,26,0.692,0.692,4,7,0.571,7,29,36,5,7,7,2,12,40
89,Kentavious Caldwell-Pope,SG,28,WAS,74,74,2246,344,793,0.434,156,396,0.394,188,397,0.474,0.532,135,152,0.888,39,213,252,140,81,25,91,133,979
90,Facundo Campazzo,PG,30,DEN,63,4,1173,106,291,0.364,57,189,0.302,49,102,0.48,0.462,60,78,0.769,23,94,117,216,61,23,66,123,329
91,Vlatko Čančar,PF,24,DEN,14,1,152,22,39,0.564,7,12,0.583,15,27,0.556,0.654,9,12,0.75,6,17,23,13,2,3,8,13,60
92,Devin Cannady,PG,25,ORL,1,0,29,3,7,0.429,3,7,0.429,0,0,,0.643,0,0,,0,0,0,2,1,0,2,0,9
93,Clint Capela,C,27,ATL,70,69,1934,341,564,0.605,0,1,0,341,563,0.606,0.605,74,159,0.465,261,568,829,92,48,91,44,158,756
94,Vernon Carey Jr.,C,20,TOT,5,1,18,3,6,0.5,0,0,,3,6,0.5,0.5,2,3,0.667,3,2,5,0,1,0,1,1,8
94,Vernon Carey Jr.,C,20,CHO,4,1,17,3,6,0.5,0,0,,3,6,0.5,0.5,2,3,0.667,3,2,5,0,1,0,1,1,8
94,Vernon Carey Jr.,C,20,WAS,1,0,1,0,0,,0,0,,0,0,,,0,0,,0,0,0,0,0,0,0,0,0
95,Jevon Carter,PG,26,TOT,62,2,843,96,239,0.402,64,163,0.393,32,76,0.421,0.536,15,18,0.833,13,88,101,87,20,13,33,61,271
95,Jevon Carter,PG,26,BRK,46,1,552,58,174,0.333,42,127,0.331,16,47,0.34,0.454,7,10,0.7,9,58,67,46,14,10,26,45,165
95,Jevon Carter,PG,26,MIL,16,1,291,38,65,0.585,22,36,0.611,16,29,0.552,0.754,8,8,1,4,30,34,41,6,3,7,16,106
96,Wendell Carter Jr.,C,22,ORL,62,61,1852,359,684,0.525,70,214,0.327,289,470,0.615,0.576,143,207,0.691,139,509,648,171,36,43,117,169,931
97,Alex Caruso,SG,27,CHI,40,17,1125,102,250,0.408,42,121,0.347,60,129,0.465,0.492,58,73,0.795,32,113,145,157,71,15,57,102,304
98,Willie Cauley-Stein,C,28,TOT,20,2,183,16,35,0.457,1,2,0.5,15,33,0.455,0.471,1,2,0.5,13,27,40,10,6,3,7,19,34
98,Willie Cauley-Stein,C,28,DAL,18,2,177,16,35,0.457,1,2,0.5,15,33,0.455,0.471,1,2,0.5,13,25,38,9,6,3,7,17,34
98,Willie Cauley-Stein,C,28,PHI,2,0,6,0,0,,0,0,,0,0,,,0,0,,0,2,2,1,0,0,0,2,0
99,Ahmad Caver,PG,25,IND,1,0,1,1,1,1,0,0,,1,1,1,1,0,0,,0,0,0,0,0,0,0,0,2
100,Justin Champagnie,SF,20,TOR,35,0,274,30,65,0.462,9,26,0.346,21,39,0.538,0.531,9,9,1,37,33,70,11,7,4,7,32,78
101,Zylan Cheatham,SF,26,UTA,1,0,5,0,3,0,0,2,0,0,1,0,0,0,0,,0,0,0,0,0,0,0,0,0
102,Chris Chiozza,PG,26,GSW,34,1,372,24,81,0.296,17,53,0.321,7,28,0.25,0.401,2,3,0.667,9,27,36,65,13,0,32,32,67
103,Marquese Chriss,PF,24,DAL,31,0,310,56,121,0.463,7,24,0.292,49,97,0.505,0.492,15,25,0.6,29,70,99,17,12,12,17,58,134
104,Josh Christopher,SG,20,HOU,70,2,1224,200,457,0.438,50,172,0.291,150,285,0.526,0.492,76,98,0.776,50,119,169,141,59,11,105,87,526
105,Gary Clark,PF,27,NOP,34,1,331,27,76,0.355,24,63,0.381,3,13,0.231,0.513,6,8,0.75,17,63,80,14,11,7,7,19,84
106,Brandon Clarke,PF,25,MEM,61,1,1195,271,425,0.638,5,22,0.227,266,403,0.66,0.644,84,128,0.656,132,202,334,83,36,68,34,117,631
107,Jordan Clarkson,SG,29,UTA,75,1,2030,446,1066,0.418,180,568,0.317,266,498,0.534,0.503,136,165,0.824,63,190,253,175,62,16,121,146,1208
108,Nic Claxton,C,22,BRK,43,19,885,162,241,0.672,0,0,,162,241,0.672,0.672,51,88,0.58,83,154,237,38,23,49,34,95,375
109,Amir Coffey,SG,24,LAC,65,29,1509,198,441,0.449,89,241,0.369,109,200,0.545,0.55,97,113,0.858,24,158,182,117,38,14,42,85,582
110,John Collins,PF,24,ATL,54,53,1663,339,644,0.526,64,176,0.364,275,468,0.588,0.576,134,169,0.793,93,329,422,98,33,56,60,164,876
111,Zach Collins,PF,24,SAS,23,2,393,56,120,0.467,11,34,0.324,45,86,0.523,0.513,36,45,0.8,39,78,117,49,9,18,35,55,159
112,Darren Collison,PG,34,LAL,3,0,37,2,7,0.286,0,3,0,2,4,0.5,0.286,0,0,,0,4,4,2,1,0,1,5,4
113,Mike Conley,PG,34,UTA,69,69,1965,329,754,0.436,163,398,0.41,166,356,0.466,0.544,125,154,0.812,46,161,207,364,91,20,115,134,946
114,Pat Connaughton,SG,29,MIL,61,19,1607,217,471,0.461,139,351,0.396,78,120,0.65,0.608,42,51,0.824,41,219,260,78,55,14,33,81,615
115,Tyler Cook,PF,24,CHI,19,2,196,22,36,0.611,0,0,,22,36,0.611,0.611,20,31,0.645,16,36,52,3,4,4,7,26,64
116,Sharife Cooper,PG,20,ATL,11,0,35,3,14,0.214,1,6,0.167,2,8,0.25,0.25,0,0,,0,5,5,5,0,0,5,1,7
117,Petr Cornelie,PF,26,DEN,13,0,38,5,15,0.333,1,8,0.125,4,7,0.571,0.367,3,4,0.75,7,7,14,3,1,1,4,7,14
118,DeMarcus Cousins,C,31,TOT,44,6,668,137,300,0.457,35,114,0.307,102,186,0.548,0.515,85,112,0.759,67,186,253,63,34,18,79,129,394
118,DeMarcus Cousins,C,31,MIL,17,5,287,55,118,0.466,13,48,0.271,42,70,0.6,0.521,31,38,0.816,24,74,98,18,16,8,16,46,154
118,DeMarcus Cousins,C,31,DEN,27,1,381,82,182,0.451,22,66,0.333,60,116,0.517,0.511,54,74,0.73,43,112,155,45,18,10,63,83,240
119,Robert Covington,PF-SF,31,TOT,67,41,1866,198,472,0.419,120,319,0.376,78,153,0.51,0.547,52,61,0.852,55,314,369,89,99,90,73,181,568
119,Robert Covington,PF,31,POR,48,40,1431,128,336,0.381,79,230,0.343,49,106,0.462,0.499,30,36,0.833,41,233,274,68,74,63,58,132,365
119,Robert Covington,SF,31,LAC,19,1,435,70,136,0.515,41,89,0.461,29,47,0.617,0.665,22,25,0.88,14,81,95,21,25,27,15,49,203
120,Torrey Craig,SF,31,TOT,73,16,1497,183,406,0.451,67,210,0.319,116,196,0.592,0.533,39,52,0.75,79,217,296,86,42,33,61,139,472
120,Torrey Craig,SF,31,IND,51,14,1034,128,281,0.456,46,138,0.333,82,143,0.573,0.537,27,35,0.771,59,136,195,58,24,19,39,95,329
120,Torrey Craig,SF,31,PHO,22,2,463,55,125,0.44,21,72,0.292,34,53,0.642,0.524,12,17,0.706,20,81,101,28,18,14,22,44,143
121,Jae Crowder,PF,31,PHO,65,65,1837,212,526,0.403,124,353,0.351,88,173,0.509,0.521,71,89,0.798,29,313,342,118,91,29,55,168,619
122,Jarrett Culver,SG,22,MEM,36,0,307,46,119,0.387,10,41,0.244,36,78,0.462,0.429,14,29,0.483,13,33,46,32,19,5,18,39,116
123,Jarron Cumberland,SG,24,POR,3,0,12,1,2,0.5,0,1,0,1,1,1,0.5,0,0,,1,2,3,1,0,0,0,2,2
124,Cade Cunningham,PG,20,DET,62,62,2011,416,994,0.419,113,354,0.319,303,640,0.473,0.475,130,155,0.839,57,284,341,340,76,41,223,192,1075
125,Seth Curry,SG,31,TOT,62,62,2076,350,720,0.486,153,361,0.424,197,359,0.549,0.592,80,91,0.879,20,175,195,224,52,14,108,143,933
125,Seth Curry,SG,31,PHI,45,45,1566,256,528,0.485,100,250,0.4,156,278,0.561,0.58,64,73,0.877,17,134,151,181,36,11,84,101,676
125,Seth Curry,SG,31,BRK,17,17,510,94,192,0.49,53,111,0.477,41,81,0.506,0.628,16,18,0.889,3,41,44,43,16,3,24,42,257
126,Stephen Curry,PG,33,GSW,64,64,2211,535,1224,0.437,285,750,0.38,250,474,0.527,0.554,275,298,0.923,34,301,335,404,85,23,206,130,1630
127,Anthony Davis,C,28,LAL,38,38,1334,349,652,0.535,13,68,0.191,336,584,0.575,0.545,167,236,0.708,104,268,372,113,46,86,78,97,878
128,Ed Davis,C,32,CLE,29,3,194,11,16,0.688,0,0,,11,16,0.688,0.688,6,14,0.429,14,50,64,6,3,9,5,32,28
129,Terence Davis,SG,24,SAC,30,11,536,113,267,0.423,49,149,0.329,64,118,0.542,0.515,36,44,0.818,11,83,94,40,25,11,33,70,311
130,Gabriel Deck,PF,26,OKC,7,0,56,8,14,0.571,2,4,0.5,6,10,0.6,0.643,0,0,,1,5,6,5,1,0,2,2,18
131,Dewayne Dedmon,C,32,MIA,66,15,1050,163,288,0.566,19,46,0.413,144,242,0.595,0.599,74,98,0.755,105,277,382,46,23,41,69,173,419
132,Sam Dekker,PF,27,TOR,1,0,1,0,0,,0,0,,0,0,,,0,0,,0,0,0,0,0,0,0,0,0
133,Javin DeLaurier,C,23,MIL,1,0,3,0,0,,0,0,,0,0,,,0,0,,0,1,1,0,1,0,0,1,0
134,DeMar DeRozan,PF,32,CHI,73,73,2643,745,1480,0.503,49,138,0.355,696,1342,0.519,0.52,506,577,0.877,54,332,386,362,65,24,170,169,2045
135,Mamadi Diakite,PF,25,OKC,13,3,188,25,47,0.532,0,5,0,25,42,0.595,0.532,6,11,0.545,17,42,59,2,5,9,7,33,56
136,Cheick Diallo,C,25,DET,3,0,31,3,8,0.375,0,0,,3,8,0.375,0.375,5,6,0.833,4,8,12,0,1,0,1,6,11
137,Hamidou Diallo,SG,23,DET,58,29,1269,261,526,0.496,23,93,0.247,238,433,0.55,0.518,91,140,0.65,69,208,277,73,71,17,58,143,636
138,Gorgui Dieng,C,32,ATL,43,3,370,53,110,0.482,29,66,0.439,24,44,0.545,0.614,19,26,0.731,32,89,121,34,11,13,20,52,154
139,Spencer Dinwiddie,PG,28,TOT,63,51,1902,291,707,0.412,104,317,0.328,187,390,0.479,0.485,187,242,0.773,43,228,271,332,41,12,98,145,873
139,Spencer Dinwiddie,PG,28,WAS,44,44,1330,185,492,0.376,70,226,0.31,115,266,0.432,0.447,116,143,0.811,36,171,207,256,27,7,73,107,556
139,Spencer Dinwiddie,PG,28,DAL,19,7,572,106,215,0.493,34,91,0.374,72,124,0.581,0.572,71,99,0.717,7,57,64,76,14,5,25,38,317
140,Donte DiVincenzo,SG,25,TOT,38,1,899,104,297,0.35,65,192,0.339,39,105,0.371,0.46,60,70,0.857,40,115,155,106,43,8,61,62,333
140,Donte DiVincenzo,SG,25,MIL,17,0,341,39,118,0.331,21,74,0.284,18,44,0.409,0.419,23,27,0.852,18,42,60,29,11,3,28,26,122
140,Donte DiVincenzo,SG,25,SAC,21,1,558,65,179,0.363,44,118,0.373,21,61,0.344,0.486,37,43,0.86,22,73,95,77,32,5,33,36,211
141,Luka Dončić,PG,22,DAL,61,61,2169,604,1321,0.457,187,530,0.353,417,791,0.527,0.528,329,443,0.743,54,504,558,523,69,34,271,138,1724
142,Luguentz Dort,SF,22,OKC,51,51,1665,293,726,0.404,130,391,0.332,163,335,0.487,0.493,161,191,0.843,38,174,212,88,46,18,88,149,877
143,Ayo Dosunmu,SG,22,CHI,73,37,1990,255,494,0.516,65,176,0.369,190,318,0.597,0.582,46,68,0.676,25,175,200,243,53,29,94,175,621
144,Damyean Dotson,SG,27,NYK,2,0,21,2,4,0.5,0,1,0,2,3,0.667,0.5,0,0,,0,2,2,1,0,0,0,0,4
145,Devon Dotson,PG,22,CHI,11,0,85,11,23,0.478,2,9,0.222,9,14,0.643,0.522,5,9,0.556,1,8,9,15,1,0,5,11,29
146,Sekou Doumbouya,PF,21,LAL,2,0,16,5,8,0.625,1,2,0.5,4,6,0.667,0.688,3,4,0.75,2,4,6,0,3,2,2,1,14
147,Jeff Dowtin,PG,24,TOT,9,0,108,8,26,0.308,1,9,0.111,7,17,0.412,0.327,2,2,1,8,10,18,10,5,1,5,5,19
147,Jeff Dowtin,PG,24,GSW,4,0,28,3,6,0.5,0,1,0,3,5,0.6,0.5,0,0,,1,6,7,3,0,1,1,2,6
147,Jeff Dowtin,PG,24,MIL,1,0,3,0,1,0,0,1,0,0,0,,0,0,0,,0,0,0,0,0,0,0,0,0
147,Jeff Dowtin,PG,24,ORL,4,0,77,5,19,0.263,1,7,0.143,4,12,0.333,0.289,2,2,1,7,4,11,7,5,0,4,3,13
148,PJ Dozier,SG,25,DEN,18,0,340,36,99,0.364,15,48,0.313,21,51,0.412,0.439,10,13,0.769,14,49,63,29,11,6,13,33,97
149,Goran Dragić,PG,35,TOT,21,8,498,57,151,0.377,16,63,0.254,41,88,0.466,0.43,27,33,0.818,13,52,65,86,19,4,34,45,157
149,Goran Dragić,PG,35,TOR,5,2,90,13,34,0.382,4,14,0.286,9,20,0.45,0.441,10,10,1,2,12,14,9,5,1,1,8,40
149,Goran Dragić,PG,35,BRK,16,6,408,44,117,0.376,12,49,0.245,32,68,0.471,0.427,17,23,0.739,11,40,51,77,14,3,33,37,117
150,Andre Drummond,C,28,TOT,69,32,1355,224,396,0.566,0,3,0,224,393,0.57,0.566,83,161,0.516,212,423,635,128,75,63,110,178,531
150,Andre Drummond,C,28,PHI,49,12,902,128,238,0.538,0,2,0,128,236,0.542,0.538,42,82,0.512,136,297,433,97,56,45,79,121,298
150,Andre Drummond,C,28,BRK,20,20,453,96,158,0.608,0,1,0,96,157,0.611,0.608,41,79,0.519,76,126,202,31,19,18,31,57,233
151,Chris Duarte,SG,24,IND,55,39,1541,268,621,0.432,94,255,0.369,174,366,0.475,0.507,90,112,0.804,41,185,226,114,56,10,90,95,720
152,David Duke Jr.,PG,22,BRK,21,7,340,39,108,0.361,9,37,0.243,30,71,0.423,0.403,17,21,0.81,30,37,67,17,14,7,9,36,104
153,Kris Dunn,PG,27,POR,11,1,259,40,81,0.494,1,7,0.143,39,74,0.527,0.5,14,14,1,5,29,34,59,20,3,22,30,95
154,Kevin Durant,PF,33,BRK,51,51,1886,547,1043,0.524,108,275,0.393,439,768,0.572,0.576,335,370,0.905,26,347,373,312,45,46,173,104,1537
155,Jaime Echenique,C,24,WAS,1,0,3,0,0,,0,0,,0,0,,,0,0,,0,0,0,0,0,0,0,0,0
156,Anthony Edwards,SG,20,MIN,68,68,2341,510,1171,0.436,204,566,0.36,306,605,0.506,0.523,201,258,0.779,59,268,327,257,101,45,183,157,1425
157,Kessler Edwards,SF,21,BRK,44,22,882,98,236,0.415,46,123,0.374,52,113,0.46,0.513,13,16,0.813,38,115,153,27,28,20,39,77,255
158,Rob Edwards,SG,25,OKC,2,0,11,1,4,0.25,1,4,0.25,0,0,,0.375,0,0,,0,3,3,0,0,0,1,0,3
159,CJ Elleby,SF,21,POR,53,23,1026,103,273,0.377,30,109,0.275,73,164,0.445,0.432,56,76,0.737,62,144,206,78,31,16,50,104,292
160,Wayne Ellington,SG,34,LAL,40,9,742,87,213,0.408,75,191,0.393,12,22,0.545,0.585,4,5,0.8,10,58,68,29,23,4,16,39,253
161,Joel Embiid,C,27,PHI,64,64,2146,612,1239,0.494,86,236,0.364,526,1003,0.524,0.529,609,746,0.816,135,601,736,273,73,91,198,173,1919
162,James Ennis III,SF,31,TOT,7,0,56,11,24,0.458,3,8,0.375,8,16,0.5,0.521,4,5,0.8,5,7,12,3,2,2,2,5,29
162,James Ennis III,SF,31,BRK,2,0,14,2,7,0.286,1,2,0.5,1,5,0.2,0.357,0,0,,2,3,5,0,1,1,0,0,5
162,James Ennis III,SF,31,LAC,2,0,28,7,11,0.636,2,4,0.5,5,7,0.714,0.727,4,4,1,2,3,5,0,1,1,1,4,20
162,James Ennis III,SF,31,DEN,3,0,14,2,6,0.333,0,2,0,2,4,0.5,0.333,0,1,0,1,1,2,3,0,0,1,1,4
163,Drew Eubanks,C,24,TOT,67,27,1121,193,327,0.59,4,19,0.211,189,308,0.614,0.596,91,120,0.758,123,230,353,83,26,37,73,107,481
163,Drew Eubanks,C,24,SAS,49,9,595,84,159,0.528,1,8,0.125,83,151,0.55,0.531,59,79,0.747,64,132,196,50,13,30,46,61,228
163,Drew Eubanks,C,24,POR,18,18,526,109,168,0.649,3,11,0.273,106,157,0.675,0.658,32,41,0.78,59,98,157,33,13,7,27,46,253
164,Tacko Fall,C,26,CLE,11,1,59,5,12,0.417,0,0,,5,12,0.417,0.417,2,7,0.286,7,16,23,2,0,6,3,3,12
165,Derrick Favors,C,30,OKC,39,18,653,94,182,0.516,2,16,0.125,92,166,0.554,0.522,16,25,0.64,58,126,184,25,17,12,9,62,206
166,Bruno Fernando,C,23,TOT,30,0,152,36,55,0.655,1,2,0.5,35,53,0.66,0.664,15,24,0.625,18,37,55,7,1,11,14,24,88
166,Bruno Fernando,C,23,BOS,20,0,58,7,14,0.5,1,1,1,6,13,0.462,0.536,4,5,0.8,7,8,15,4,0,3,5,6,19
166,Bruno Fernando,C,23,HOU,10,0,94,29,41,0.707,0,1,0,29,40,0.725,0.707,11,19,0.579,11,29,40,3,1,8,9,18,69
167,Dorian Finney-Smith,PF,28,DAL,76,76,2516,306,662,0.462,159,412,0.386,147,250,0.588,0.582,54,81,0.667,119,242,361,139,82,37,79,178,825
168,Malik Fitts,PF,24,TOT,12,0,46,3,13,0.231,3,8,0.375,0,5,0,0.346,0,0,,0,13,13,0,0,0,2,3,9
168,Malik Fitts,PF,24,UTA,7,0,35,2,9,0.222,2,4,0.5,0,5,0,0.333,0,0,,0,10,10,0,0,0,2,3,6
168,Malik Fitts,PF,24,BOS,5,0,11,1,4,0.25,1,4,0.25,0,0,,0.375,0,0,,0,3,3,0,0,0,0,0,3
169,Malachi Flynn,PG,23,TOR,40,5,479,66,162,0.407,27,81,0.333,39,81,0.481,0.491,14,23,0.609,9,48,57,63,18,4,11,42,173
170,Bryn Forbes,SG,28,TOT,73,1,1243,224,523,0.428,117,284,0.412,107,239,0.448,0.54,72,80,0.9,10,82,92,73,24,5,55,93,637
170,Bryn Forbes,SG,28,SAS,40,1,676,128,296,0.432,63,151,0.417,65,145,0.448,0.539,44,49,0.898,4,59,63,41,17,3,33,42,363
170,Bryn Forbes,SG,28,DEN,33,0,567,96,227,0.423,54,133,0.406,42,94,0.447,0.542,28,31,0.903,6,23,29,32,7,2,22,51,274
171,Aleem Ford,SF,24,ORL,5,0,74,6,20,0.3,2,15,0.133,4,5,0.8,0.35,0,0,,2,13,15,2,1,0,4,7,14
172,Trent Forrest,PG,23,UTA,59,5,753,74,153,0.484,5,27,0.185,69,126,0.548,0.5,38,48,0.792,23,75,98,104,30,5,46,43,191
173,Evan Fournier,SG,29,NYK,76,76,2254,390,926,0.421,233,590,0.395,157,336,0.467,0.547,79,111,0.712,33,165,198,160,74,18,103,169,1092
174,De'Aaron Fox,PG,24,SAC,59,59,2083,516,1092,0.473,74,249,0.297,442,843,0.524,0.506,261,348,0.75,25,206,231,330,68,25,168,172,1367
175,Tim Frazier,PG,31,TOT,12,3,208,14,45,0.311,6,17,0.353,8,28,0.286,0.378,5,9,0.556,5,14,19,34,3,1,15,27,39
175,Tim Frazier,PG,31,ORL,10,3,200,13,43,0.302,6,17,0.353,7,26,0.269,0.372,5,9,0.556,5,14,19,33,3,1,13,24,37
175,Tim Frazier,PG,31,CLE,2,0,8,1,2,0.5,0,0,,1,2,0.5,0.5,0,0,,0,0,0,1,0,0,2,3,2
176,Enes Freedom,C,29,BOS,35,1,411,51,97,0.526,2,5,0.4,49,92,0.533,0.536,24,28,0.857,61,99,160,8,5,14,20,42,128
177,Markelle Fultz,PG,23,ORL,14,0,261,60,132,0.455,3,11,0.273,57,121,0.471,0.466,23,28,0.821,4,33,37,66,17,5,28,16,146
178,Wenyen Gabriel,PF,24,TOT,21,4,258,37,83,0.446,7,26,0.269,30,57,0.526,0.488,18,29,0.621,32,44,76,9,5,6,12,53,99
178,Wenyen Gabriel,PF,24,BRK,1,0,1,0,0,,0,0,,0,0,,,0,0,,0,1,1,0,0,0,0,0,0
178,Wenyen Gabriel,PF,24,LAC,6,0,46,5,13,0.385,2,5,0.4,3,8,0.375,0.462,2,4,0.5,5,9,14,2,1,2,3,11,14
178,Wenyen Gabriel,PF,24,LAL,14,4,211,32,70,0.457,5,21,0.238,27,49,0.551,0.493,16,25,0.64,27,34,61,7,4,4,9,42,85
179,Daniel Gafford,C,23,WAS,67,51,1336,258,374,0.69,0,1,0,258,373,0.692,0.69,94,133,0.707,148,236,384,64,28,94,63,156,610
180,Danilo Gallinari,PF,33,ATL,63,15,1573,236,555,0.425,101,273,0.37,135,282,0.479,0.516,139,154,0.903,32,260,292,98,27,11,34,88,712
181,Langston Galloway,SG,30,TOT,7,0,107,6,26,0.231,2,16,0.125,4,10,0.4,0.269,0,0,,3,15,18,12,1,0,6,7,14
181,Langston Galloway,SG,30,BRK,4,0,58,5,13,0.385,2,8,0.25,3,5,0.6,0.462,0,0,,1,7,8,5,0,0,5,5,12
181,Langston Galloway,SG,30,MIL,3,0,49,1,13,0.077,0,8,0,1,5,0.2,0.077,0,0,,2,8,10,7,1,0,1,2,2
182,Darius Garland,PG,22,CLE,64,64,2288,508,1100,0.462,163,432,0.377,345,668,0.516,0.536,202,226,0.894,36,176,212,558,81,7,244,111,1381
183,Marcus Garrett,SG,23,MIA,12,0,128,5,21,0.238,1,4,0.25,4,17,0.235,0.262,2,5,0.4,9,14,23,7,5,3,2,16,13
184,Usman Garuba,PF,19,HOU,20,2,183,13,35,0.371,4,17,0.235,9,18,0.5,0.429,5,7,0.714,15,47,62,12,8,9,5,17,35
185,Luka Garza,C,23,DET,31,5,358,58,129,0.45,14,42,0.333,44,87,0.506,0.504,36,55,0.655,51,39,90,16,9,5,17,52,166
186,Rudy Gay,PF,35,UTA,52,1,981,148,361,0.41,68,195,0.349,80,166,0.482,0.504,60,76,0.789,54,175,229,51,25,15,45,93,424
187,Paul George,SF,31,LAC,28,28,987,251,596,0.421,78,235,0.332,173,361,0.479,0.487,117,135,0.867,11,180,191,153,60,11,116,70,697
188,Taj Gibson,C,36,NYK,48,4,875,78,148,0.527,14,34,0.412,64,114,0.561,0.574,38,48,0.792,79,132,211,28,19,37,24,132,208
189,Josh Giddey,SG,19,OKC,54,54,1700,281,670,0.419,56,213,0.263,225,457,0.492,0.461,56,79,0.709,98,323,421,345,51,20,171,88,674
190,Shai Gilgeous-Alexander,PG,23,OKC,56,56,1942,477,1052,0.453,89,297,0.3,388,755,0.514,0.496,328,405,0.81,37,241,278,331,71,46,154,142,1371
191,Anthony Gill,PF,29,WAS,40,0,390,54,86,0.628,12,21,0.571,42,65,0.646,0.698,34,44,0.773,27,45,72,22,4,11,14,51,154
192,Freddie Gillespie,PF,24,ORL,9,2,119,9,22,0.409,0,1,0,9,21,0.429,0.409,3,7,0.429,13,23,36,5,3,9,5,18,21
193,Rudy Gobert,C,29,UTA,62,62,1997,339,478,0.709,0,4,0,339,474,0.715,0.709,273,394,0.693,227,685,912,68,43,131,110,163,951
194,Brandon Goodwin,PG,26,CLE,34,5,492,64,152,0.421,19,55,0.345,45,97,0.464,0.484,24,38,0.632,14,53,67,90,25,1,34,37,171
195,Jordan Goodwin,SG,23,WAS,2,0,6,0,3,0,0,1,0,0,2,0,0,0,0,,0,1,1,0,0,0,0,1,0
196,Aaron Gordon,PF,26,DEN,72,72,2269,410,793,0.517,81,247,0.328,329,546,0.603,0.568,161,217,0.742,120,293,413,181,43,41,126,144,1062
197,Eric Gordon,SG,33,HOU,57,46,1669,268,564,0.475,124,301,0.412,144,263,0.548,0.585,105,135,0.778,15,98,113,154,28,18,107,63,765
198,Devonte' Graham,PG,26,NOP,72,61,2088,286,793,0.361,187,547,0.342,99,246,0.402,0.479,112,133,0.842,37,139,176,303,67,12,101,92,871
199,Jerami Grant,PF,27,DET,47,47,1500,298,699,0.426,91,254,0.358,207,445,0.465,0.491,217,259,0.838,28,163,191,111,44,49,85,107,904
200,Hassani Gravett,PG,25,ORL,8,3,171,18,38,0.474,11,26,0.423,7,12,0.583,0.618,3,4,0.75,1,20,21,20,5,1,9,13,50
201,Danny Green,SF,34,PHI,57,25,1229,113,291,0.388,91,247,0.368,22,44,0.5,0.545,10,12,0.833,26,111,137,53,51,34,39,96,327
202,Draymond Green,PF,31,GSW,42,40,1222,120,231,0.519,13,50,0.26,107,181,0.591,0.548,58,89,0.652,44,266,310,294,56,45,128,120,311
203,Jalen Green,SG,19,HOU,63,63,1985,365,877,0.416,145,426,0.34,220,451,0.488,0.499,172,212,0.811,31,180,211,163,42,17,126,97,1047
204,JaMychal Green,PF,31,DEN,63,7,1018,151,313,0.482,33,122,0.27,118,191,0.618,0.535,78,89,0.876,75,189,264,53,40,25,54,147,413
205,Javonte Green,SF,28,CHI,61,44,1421,164,302,0.543,34,94,0.362,130,208,0.625,0.599,78,94,0.83,88,169,257,57,60,30,29,127,440
206,Jeff Green,C,35,DEN,73,61,1798,269,518,0.519,53,167,0.317,216,351,0.615,0.57,160,192,0.833,41,183,224,93,28,26,68,147,751
207,Josh Green,SG,21,DAL,63,3,974,121,242,0.5,24,69,0.348,97,173,0.561,0.55,30,43,0.698,50,96,146,74,42,14,42,108,296
208,Blake Griffin,PF,32,BRK,56,24,958,133,313,0.425,38,145,0.262,95,168,0.565,0.486,55,76,0.724,60,168,228,105,27,14,31,95,359
209,Quentin Grimes,SG,21,NYK,45,6,770,94,230,0.409,72,185,0.389,22,45,0.489,0.565,13,19,0.684,23,67,90,42,31,11,28,71,273
210,Kyle Guy,SG,24,MIA,19,0,186,26,65,0.4,14,40,0.35,12,25,0.48,0.508,8,12,0.667,4,13,17,17,7,1,13,12,74
211,Rui Hachimura,PF,23,WAS,37,8,789,158,316,0.5,48,102,0.471,110,214,0.514,0.576,39,52,0.75,21,114,135,41,22,8,30,46,403
212,Tyrese Haliburton,SG-PG,21,TOT,73,73,2542,403,860,0.469,156,374,0.417,247,486,0.508,0.559,143,171,0.836,56,233,289,587,129,46,186,116,1105
212,Tyrese Haliburton,SG,21,SAC,51,51,1757,268,586,0.457,104,252,0.413,164,334,0.491,0.546,87,104,0.837,39,160,199,379,86,34,115,71,727
212,Tyrese Haliburton,PG,21,IND,22,22,785,135,274,0.493,52,122,0.426,83,152,0.546,0.588,56,67,0.836,17,73,90,208,43,12,71,45,378
213,Tyler Hall,SG,24,NYK,1,0,2,0,0,,0,0,,0,0,,,0,0,,0,0,0,0,0,0,0,0,0
214,R.J. Hampton,SG,20,ORL,60,12,1276,156,406,0.384,59,167,0.353,97,239,0.406,0.457,68,108,0.63,19,158,177,139,41,13,77,94,439
215,Tim Hardaway Jr.,SG,29,DAL,42,20,1245,209,530,0.394,102,304,0.336,107,226,0.473,0.491,78,103,0.757,13,143,156,92,38,6,34,74,598
216,James Harden,PG-SG,32,TOT,61,61,2261,389,941,0.413,141,421,0.335,248,520,0.477,0.488,446,510,0.875,51,428,479,614,80,36,268,146,1365
216,James Harden,PG,32,BRK,44,44,1627,292,706,0.414,102,307,0.332,190,399,0.476,0.486,304,350,0.869,42,309,351,447,56,31,212,105,990
216,James Harden,SG,32,PHI,17,17,634,97,235,0.413,39,114,0.342,58,121,0.479,0.496,142,160,0.888,9,119,128,167,24,5,56,41,375
217,Maurice Harkless,SF,28,SAC,47,24,863,83,181,0.459,31,101,0.307,52,80,0.65,0.544,20,28,0.714,12,100,112,23,29,24,31,77,217
218,Jared Harper,PG,24,NOP,2,0,10,3,7,0.429,1,2,0.5,2,5,0.4,0.5,0,0,,1,0,1,3,0,1,1,2,7
219,Montrezl Harrell,C,28,TOT,68,3,1577,341,535,0.637,4,17,0.235,337,518,0.651,0.641,210,293,0.717,145,276,421,139,27,40,68,131,896
219,Montrezl Harrell,C,28,WAS,46,3,1117,247,383,0.645,4,15,0.267,243,368,0.66,0.65,149,205,0.727,96,213,309,96,18,31,50,88,647
219,Montrezl Harrell,C,28,CHO,22,0,460,94,152,0.618,0,2,0,94,150,0.627,0.618,61,88,0.693,49,63,112,43,9,9,18,43,249
220,Gary Harris,SG,27,ORL,61,30,1730,240,553,0.434,116,302,0.384,124,251,0.494,0.539,83,95,0.874,36,86,122,108,59,9,61,112,679
221,Joe Harris,SF,30,BRK,14,14,423,56,124,0.452,41,88,0.466,15,36,0.417,0.617,5,6,0.833,5,51,56,14,7,2,16,31,158
222,Tobias Harris,PF,29,PHI,68,68,2376,470,966,0.487,93,256,0.363,377,710,0.531,0.535,164,194,0.845,74,395,469,237,40,41,107,148,1197
223,Shaquille Harrison,SG,28,BRK,2,0,23,2,6,0.333,0,2,0,2,4,0.5,0.333,0,0,,1,3,4,3,1,1,2,3,4
224,Josh Hart,SG-SF,26,TOT,54,53,1791,287,569,0.504,73,213,0.343,214,356,0.601,0.569,160,211,0.758,62,326,388,224,61,13,114,150,807
224,Josh Hart,SG,26,NOP,41,40,1374,195,386,0.505,42,130,0.323,153,256,0.598,0.56,116,154,0.753,53,265,318,168,45,11,81,118,548
224,Josh Hart,SF,26,POR,13,13,417,92,183,0.503,31,83,0.373,61,100,0.61,0.587,44,57,0.772,9,61,70,56,16,2,33,32,259
225,Isaiah Hartenstein,C,23,LAC,64,0,1122,215,339,0.634,7,20,0.35,208,319,0.652,0.645,82,123,0.667,105,198,303,144,48,73,79,159,519
226,Udonis Haslem,C,41,MIA,12,0,63,13,26,0.5,1,3,0.333,12,23,0.522,0.519,3,3,1,4,15,19,3,1,1,4,11,30
227,Sam Hauser,SF,24,BOS,22,0,117,17,37,0.459,15,33,0.455,2,4,0.5,0.662,0,0,,4,16,20,4,1,2,2,7,49
228,Jaxson Hayes,C,21,NOP,65,23,1281,220,347,0.634,16,45,0.356,204,302,0.675,0.657,134,173,0.775,101,182,283,38,29,53,53,148,590
229,Killian Hayes,PG,20,DET,62,36,1557,163,425,0.384,40,153,0.261,123,272,0.452,0.431,52,68,0.765,36,166,202,264,74,34,109,174,418
230,Gordon Hayward,SF,31,CHO,49,48,1564,283,617,0.459,86,220,0.391,197,397,0.496,0.528,126,149,0.846,38,186,224,177,47,22,81,85,778
231,Aaron Henry,SF,22,PHI,6,0,17,1,5,0.2,0,1,0,1,4,0.25,0.2,0,0,,0,1,1,0,0,2,2,2,2
232,Juancho Hernangómez,PF,26,TOT,37,7,384,33,86,0.384,20,61,0.328,13,25,0.52,0.5,15,27,0.556,22,64,86,18,12,10,15,23,101
232,Juancho Hernangómez,PF,26,BOS,18,0,96,5,27,0.185,3,18,0.167,2,9,0.222,0.241,6,9,0.667,9,16,25,3,4,2,6,7,19
232,Juancho Hernangómez,PF,26,SAS,5,0,51,2,6,0.333,0,3,0,2,3,0.667,0.333,3,4,0.75,4,11,15,3,1,1,2,0,7
232,Juancho Hernangómez,PF,26,UTA,14,7,237,26,53,0.491,17,40,0.425,9,13,0.692,0.651,6,14,0.429,9,37,46,12,7,7,7,16,75
233,Willy Hernangómez,C,27,NOP,46,6,734,152,285,0.533,4,11,0.364,148,274,0.54,0.54,93,123,0.756,121,172,293,53,19,18,47,85,401
234,Tyler Herro,SG,22,MIA,63,10,2048,476,1076,0.442,167,422,0.396,309,654,0.472,0.52,180,208,0.865,30,279,309,243,42,8,160,89,1299
235,Buddy Hield,SG,29,TOT,77,28,2365,416,1031,0.403,249,675,0.369,167,356,0.469,0.524,107,123,0.87,62,266,328,213,69,23,142,172,1188
235,Buddy Hield,SG,29,SAC,55,6,1574,265,693,0.382,182,495,0.368,83,198,0.419,0.514,80,92,0.87,43,178,221,105,48,15,90,113,792
235,Buddy Hield,SG,29,IND,22,22,791,151,338,0.447,67,180,0.372,84,158,0.532,0.546,27,31,0.871,19,88,107,108,21,8,52,59,396
236,Haywood Highsmith,SF,25,MIA,17,0,120,9,27,0.333,7,18,0.389,2,9,0.222,0.463,2,4,0.5,7,14,21,3,2,2,2,10,27
237,George Hill,SG,35,MIL,50,17,1187,113,263,0.43,40,128,0.313,73,135,0.541,0.506,51,56,0.911,36,111,147,115,38,6,39,63,317
238,Malcolm Hill,SF-SG,26,TOT,17,0,197,23,49,0.469,13,34,0.382,10,15,0.667,0.602,11,14,0.786,11,21,32,5,6,3,2,22,70
238,Malcolm Hill,SG,26,ATL,3,0,46,5,8,0.625,3,5,0.6,2,3,0.667,0.813,4,4,1,2,4,6,1,4,1,0,7,17
238,Malcolm Hill,SF,26,CHI,14,0,151,18,41,0.439,10,29,0.345,8,12,0.667,0.561,7,10,0.7,9,17,26,4,2,2,2,15,53
239,Solomon Hill,PF,30,ATL,13,1,139,3,20,0.15,2,13,0.154,1,7,0.143,0.2,0,0,,6,17,23,12,4,2,1,16,8
240,Nate Hinton,SG,22,IND,2,0,2,0,1,0,0,0,,0,1,0,0,0,0,,0,0,0,0,0,0,1,0,0
241,Jaylen Hoard,SF,22,OKC,2,1,42,5,10,0.5,1,3,0.333,4,7,0.571,0.55,0,2,0,7,15,22,3,0,2,0,1,11
242,Aaron Holiday,PG,25,TOT,58,14,953,144,308,0.468,36,91,0.396,108,217,0.498,0.526,50,58,0.862,20,91,111,141,40,9,61,81,374
242,Aaron Holiday,PG,25,WAS,41,14,663,100,214,0.467,23,67,0.343,77,147,0.524,0.521,28,35,0.8,9,58,67,78,24,9,39,60,251
242,Aaron Holiday,PG,25,PHO,17,0,290,44,94,0.468,13,24,0.542,31,70,0.443,0.537,22,23,0.957,11,33,44,63,16,0,22,21,123
243,Jrue Holiday,PG,31,MIL,62,59,2070,451,900,0.501,122,297,0.411,329,603,0.546,0.569,131,171,0.766,63,219,282,418,104,26,175,121,1155
244,Justin Holiday,SF-SG,32,TOT,70,61,1964,248,635,0.391,166,465,0.357,82,170,0.482,0.521,50,62,0.806,28,154,182,120,52,33,68,146,712
244,Justin Holiday,SF,32,IND,49,40,1416,190,458,0.415,127,336,0.378,63,122,0.516,0.553,34,41,0.829,18,117,135,90,36,18,49,105,541
244,Justin Holiday,SG,32,SAC,21,21,548,58,177,0.328,39,129,0.302,19,48,0.396,0.438,16,21,0.762,10,37,47,30,16,15,19,41,171
245,Richaun Holmes,C,28,SAC,45,37,1074,198,300,0.66,2,5,0.4,196,295,0.664,0.663,70,90,0.778,93,224,317,48,17,41,56,128,468
246,Rodney Hood,SF-SG,29,TOT,49,0,682,56,155,0.361,28,89,0.315,28,66,0.424,0.452,15,17,0.882,15,59,74,36,15,6,11,29,155
246,Rodney Hood,SF,29,MIL,39,0,581,46,131,0.351,24,80,0.3,22,51,0.431,0.443,13,14,0.929,13,54,67,30,12,4,7,27,129
246,Rodney Hood,SG,29,LAC,10,0,101,10,24,0.417,4,9,0.444,6,15,0.4,0.5,2,3,0.667,2,5,7,6,3,2,4,2,26
247,Scotty Hopson,SG,32,OKC,1,0,18,2,4,0.5,0,1,0,2,3,0.667,0.5,0,0,,0,1,1,1,0,0,2,1,4
248,Al Horford,C,35,BOS,66,66,1922,249,545,0.457,83,255,0.325,166,290,0.572,0.533,80,95,0.842,103,403,506,222,46,89,63,128,661
249,Talen Horton-Tucker,SG,21,LAL,55,16,1387,197,475,0.415,45,166,0.271,152,309,0.492,0.462,79,102,0.775,34,140,174,143,51,28,78,140,518
250,Danuel House Jr.,SF,28,TOT,38,5,621,68,169,0.402,37,97,0.381,31,72,0.431,0.512,35,45,0.778,15,82,97,42,16,14,26,44,208
250,Danuel House Jr.,SF,28,HOU,16,1,233,25,74,0.338,10,34,0.294,15,40,0.375,0.405,17,19,0.895,4,39,43,19,5,5,18,16,77
250,Danuel House Jr.,SF,28,NYK,1,0,3,0,1,0,0,1,0,0,0,,0,0,0,,0,0,0,0,0,0,0,0,0
250,Danuel House Jr.,SF,28,UTA,21,4,385,43,94,0.457,27,62,0.435,16,32,0.5,0.601,18,26,0.692,11,43,54,23,11,9,8,28,131
251,Dwight Howard,C,36,LAL,56,23,879,118,194,0.608,7,11,0.636,111,183,0.607,0.626,80,124,0.645,110,212,322,30,32,34,43,111,323
252,Markus Howard,SG,22,DEN,29,0,149,31,82,0.378,26,60,0.433,5,22,0.227,0.537,13,15,0.867,0,9,9,6,8,0,6,11,101
253,Kevin Huerter,SG,23,ATL,70,56,2068,325,719,0.452,150,387,0.388,175,332,0.527,0.556,40,50,0.8,31,206,237,188,51,25,88,173,840
254,Jay Huff,C,23,LAL,4,0,20,0,3,0,0,2,0,0,1,0,0,0,0,,1,3,4,1,1,1,1,1,0
255,Elijah Hughes,SG-SF,23,TOT,32,4,367,40,120,0.333,22,80,0.275,18,40,0.45,0.425,5,7,0.714,5,45,50,19,12,6,13,34,107
255,Elijah Hughes,SF,23,UTA,14,1,112,15,36,0.417,10,28,0.357,5,8,0.625,0.556,3,3,1,2,15,17,6,4,1,7,7,43
255,Elijah Hughes,SG,23,POR,18,3,255,25,84,0.298,12,52,0.231,13,32,0.406,0.369,2,4,0.5,3,30,33,13,8,5,6,27,64
256,De'Andre Hunter,SF,24,ATL,49,48,1455,235,525,0.448,68,183,0.372,167,342,0.488,0.512,117,154,0.76,23,140,163,65,35,19,62,141,655
257,Chandler Hutchison,SF,25,PHO,6,0,22,1,2,0.5,0,0,,1,2,0.5,0.5,2,2,1,0,5,5,2,0,0,4,1,4
258,Bones Hyland,PG,21,DEN,65,3,1221,212,532,0.398,123,333,0.369,89,199,0.447,0.514,101,119,0.849,13,167,180,170,38,17,82,143,648
259,Serge Ibaka,C-PF,32,TOT,53,12,866,144,291,0.495,37,98,0.378,107,193,0.554,0.558,32,44,0.727,60,186,246,49,11,33,43,99,357
259,Serge Ibaka,C,32,LAC,35,10,538,94,192,0.49,24,62,0.387,70,130,0.538,0.552,20,29,0.69,40,110,150,36,7,26,33,56,232
259,Serge Ibaka,PF,32,MIL,18,2,328,50,99,0.505,13,36,0.361,37,63,0.587,0.571,12,15,0.8,20,76,96,13,4,7,10,43,125
260,Andre Iguodala,SF,38,GSW,29,0,565,43,111,0.387,16,69,0.232,27,42,0.643,0.459,14,18,0.778,21,74,95,106,24,22,26,32,116
261,Joe Ingles,SF,34,UTA,45,15,1122,115,285,0.404,78,225,0.347,37,60,0.617,0.54,17,22,0.773,12,119,131,158,23,5,46,82,325
262,Brandon Ingram,SF,24,NOP,53,53,1800,445,957,0.465,72,221,0.326,373,736,0.507,0.503,252,306,0.824,35,270,305,295,34,26,143,114,1214
263,Kyrie Irving,PG,29,BRK,25,25,929,245,524,0.468,84,198,0.424,161,326,0.494,0.548,103,113,0.912,13,90,103,141,33,16,61,70,677
264,Wes Iwundu,SF,27,ATL,3,1,82,8,18,0.444,3,5,0.6,5,13,0.385,0.528,3,4,0.75,3,10,13,0,1,0,1,8,22
265,Frank Jackson,PG,23,DET,49,5,1073,181,448,0.404,82,262,0.313,99,186,0.532,0.496,75,91,0.824,16,60,76,47,26,9,36,84,519
266,Isaiah Jackson,PF,20,IND,32,12,430,94,170,0.553,4,13,0.308,90,157,0.573,0.565,47,72,0.653,52,76,128,9,17,42,32,78,239
267,Jaren Jackson Jr.,PF,22,MEM,75,75,2042,416,996,0.418,123,385,0.319,293,611,0.48,0.479,267,326,0.819,117,319,436,83,71,169,126,264,1222
268,Josh Jackson,SF,24,TOT,47,3,756,109,270,0.404,31,121,0.256,78,149,0.523,0.461,47,68,0.691,18,110,128,52,23,21,42,80,296
268,Josh Jackson,SF,24,DET,39,3,707,103,251,0.41,30,113,0.265,73,138,0.529,0.47,40,56,0.714,17,106,123,49,21,18,38,71,276
268,Josh Jackson,SF,24,SAC,8,0,49,6,19,0.316,1,8,0.125,5,11,0.455,0.342,7,12,0.583,1,4,5,3,2,3,4,9,20
269,Justin Jackson,SF,26,TOT,7,0,37,5,15,0.333,3,9,0.333,2,6,0.333,0.433,2,2,1,1,6,7,2,0,0,1,3,15
269,Justin Jackson,SF,26,BOS,1,0,2,0,1,0,0,0,,0,1,0,0,2,2,1,0,0,0,0,0,0,0,0,2
269,Justin Jackson,SF,26,PHO,6,0,35,5,14,0.357,3,9,0.333,2,5,0.4,0.464,0,0,,1,6,7,2,0,0,1,3,13
270,Reggie Jackson,SG,31,LAC,72,72,2251,467,1183,0.395,165,495,0.333,302,688,0.439,0.464,136,161,0.845,39,225,264,346,52,13,165,153,1235
271,LeBron James,SF,37,LAL,56,56,2084,640,1221,0.524,161,448,0.359,479,773,0.62,0.59,254,336,0.756,63,396,459,349,73,59,196,121,1695
272,DeJon Jarreau,SG,24,IND,1,0,1,0,0,,0,0,,0,0,,,0,0,,0,0,0,0,0,0,0,0,0
273,DaQuan Jeffries,SG,24,MEM,3,0,9,1,2,0.5,0,1,0,1,1,1,0.5,0,0,,0,2,2,1,0,0,0,1,2
274,Ty Jerome,SG,24,OKC,48,4,801,124,328,0.378,54,186,0.29,70,142,0.493,0.46,38,47,0.809,19,59,78,109,30,5,37,73,340
275,Isaiah Joe,SG,22,PHI,53,1,572,58,165,0.352,42,126,0.333,16,39,0.41,0.479,27,29,0.931,6,45,51,33,12,3,16,44,185
276,Alize Johnson,PF,25,TOT,23,0,167,17,39,0.436,0,4,0,17,35,0.486,0.436,7,12,0.583,28,33,61,9,5,0,12,18,41
276,Alize Johnson,PF,25,CHI,16,0,121,12,23,0.522,0,2,0,12,21,0.571,0.522,4,7,0.571,16,20,36,8,3,0,8,15,28
276,Alize Johnson,PF,25,WAS,3,0,18,2,6,0.333,0,2,0,2,4,0.5,0.333,0,1,0,5,7,12,0,0,0,3,0,4
276,Alize Johnson,PF,25,NOP,4,0,28,3,10,0.3,0,0,,3,10,0.3,0.3,3,4,0.75,7,6,13,1,2,0,1,3,9
277,B.J. Johnson,SF,26,ORL,4,0,65,11,25,0.44,4,10,0.4,7,15,0.467,0.52,0,0,,6,9,15,0,0,1,0,4,26
278,Cameron Johnson,PF,25,PHO,61,13,1596,261,554,0.471,159,358,0.444,102,196,0.52,0.615,90,104,0.865,36,212,248,89,50,14,39,104,771
279,David Johnson,SG,20,TOR,2,0,2,0,1,0,0,1,0,0,0,,0,0,0,,0,0,0,0,0,0,0,0,0
280,Jalen Johnson,PF,20,ATL,19,0,111,22,39,0.564,3,12,0.25,19,27,0.704,0.603,5,7,0.714,2,23,25,3,3,2,9,9,52
281,James Johnson,PF,34,BRK,62,10,1191,144,307,0.469,23,85,0.271,121,222,0.545,0.507,29,55,0.527,51,164,215,130,30,34,48,162,340
282,Joe Johnson,SG,40,BOS,1,0,2,1,1,1,0,0,,1,1,1,1,0,0,,0,0,0,0,0,0,0,0,2
283,Keldon Johnson,SF,22,SAS,71,70,2254,439,942,0.466,148,368,0.402,291,574,0.507,0.545,160,211,0.758,79,356,435,145,53,12,89,134,1186
284,Keon Johnson,SG,19,TOT,32,7,539,73,208,0.351,26,72,0.361,47,136,0.346,0.413,34,43,0.791,23,45,68,47,22,8,33,57,206
284,Keon Johnson,SG,19,LAC,15,0,135,17,51,0.333,3,11,0.273,14,40,0.35,0.363,16,21,0.762,6,15,21,13,7,2,7,21,53
284,Keon Johnson,SG,19,POR,17,7,404,56,157,0.357,23,61,0.377,33,96,0.344,0.43,18,22,0.818,17,30,47,34,15,6,26,36,153
285,Stanley Johnson,PF,25,LAL,43,24,951,101,213,0.474,29,88,0.33,72,125,0.576,0.542,40,54,0.741,29,99,128,72,40,14,23,102,271
286,Tyler Johnson,PG,29,TOT,6,0,91,6,20,0.3,5,13,0.385,1,7,0.143,0.425,0,0,,3,9,12,7,3,3,2,7,17
286,Tyler Johnson,PG,29,PHI,3,0,38,4,10,0.4,3,7,0.429,1,3,0.333,0.55,0,0,,1,5,6,2,1,1,1,4,11
286,Tyler Johnson,PG,29,SAS,3,0,53,2,10,0.2,2,6,0.333,0,4,0,0.3,0,0,,2,4,6,5,2,2,1,3,6
287,Nikola Jokić,C,26,DEN,71,71,2367,715,1230,0.581,95,277,0.343,620,953,0.651,0.62,365,449,0.813,200,768,968,568,101,60,269,183,1890
288,Carlik Jones,PG,24,TOT,5,0,23,1,9,0.111,0,1,0,1,8,0.125,0.111,2,2,1,1,2,3,5,1,0,3,0,4
288,Carlik Jones,PG,24,DAL,3,0,19,0,7,0,0,1,0,0,6,0,0,2,2,1,1,2,3,5,1,0,3,0,2
288,Carlik Jones,PG,24,DEN,2,0,4,1,2,0.5,0,0,,1,2,0.5,0.5,0,0,,0,0,0,0,0,0,0,0,2
289,Damian Jones,C,26,SAC,52,11,895,150,230,0.652,8,24,0.333,142,206,0.689,0.67,76,106,0.717,71,155,226,61,22,44,51,119,384
290,Derrick Jones Jr.,PF,24,CHI,47,8,808,95,174,0.546,16,50,0.32,79,124,0.637,0.592,49,62,0.79,55,101,156,25,22,30,25,98,255
291,Herbert Jones,PF,23,NOP,74,65,2228,263,551,0.477,54,159,0.34,209,392,0.533,0.526,128,152,0.842,89,190,279,161,123,56,97,231,708
292,Jemerrio Jones,SF,26,LAL,2,0,15,2,3,0.667,0,0,,2,3,0.667,0.667,0,0,,2,1,3,0,1,0,0,2,4
293,Kai Jones,C,21,CHO,19,0,58,8,13,0.615,1,2,0.5,7,11,0.636,0.654,3,8,0.375,3,7,10,4,1,0,6,7,20
294,Mason Jones,SG,23,LAL,2,0,9,2,8,0.25,0,2,0,2,6,0.333,0.25,1,2,0.5,1,1,2,0,1,0,1,1,5
295,Tre Jones,PG,22,SAS,64,7,998,139,285,0.488,5,39,0.128,134,246,0.545,0.496,57,72,0.792,28,108,136,195,36,6,41,67,340
296,Tyus Jones,PG,25,MEM,70,21,1473,237,524,0.452,75,197,0.381,162,327,0.495,0.524,54,66,0.818,17,155,172,307,64,2,43,31,603
297,DeAndre Jordan,C,33,TOT,45,19,579,82,131,0.626,0,0,,82,131,0.626,0.626,22,38,0.579,77,166,243,19,12,34,36,66,186
297,DeAndre Jordan,C,33,LAL,32,19,408,60,89,0.674,0,0,,60,89,0.674,0.674,12,26,0.462,51,121,172,13,10,26,21,50,132
297,DeAndre Jordan,C,33,PHI,13,0,171,22,42,0.524,0,0,,22,42,0.524,0.524,10,12,0.833,26,45,71,6,2,8,15,16,54
298,Cory Joseph,PG,30,DET,65,39,1600,178,400,0.445,65,157,0.414,113,243,0.465,0.526,100,113,0.885,29,145,174,237,42,17,85,147,521
299,Georgios Kalaitzakis,SF,23,MIL,9,0,48,5,11,0.455,2,4,0.5,3,7,0.429,0.545,4,9,0.444,4,4,8,0,1,1,4,8,16
300,Frank Kaminsky,C,28,PHO,9,0,181,36,66,0.545,5,15,0.333,31,51,0.608,0.583,18,20,0.9,11,30,41,13,8,7,5,14,95
301,Luke Kennard,SG,25,LAC,67,12,1847,271,606,0.447,180,402,0.448,91,204,0.446,0.596,67,74,0.905,17,206,223,140,39,6,56,99,789
302,Braxton Key,SF,24,TOT,7,0,108,16,42,0.381,3,11,0.273,13,31,0.419,0.417,1,3,0.333,8,20,28,3,5,8,6,17,36
302,Braxton Key,SF,24,PHI,2,0,6,1,2,0.5,0,1,0,1,1,1,0.5,0,0,,1,1,2,1,1,0,2,1,2
302,Braxton Key,SF,24,DET,5,0,102,15,40,0.375,3,10,0.3,12,30,0.4,0.413,1,3,0.333,7,19,26,2,4,8,4,16,34
303,George King,SF,28,DAL,4,0,19,0,5,0,0,4,0,0,1,0,0,1,2,0.5,0,5,5,0,0,0,1,4,1
304,Louis King,SF,22,SAC,10,0,104,15,47,0.319,8,27,0.296,7,20,0.35,0.404,7,10,0.7,0,12,12,9,2,1,0,14,45
305,Corey Kispert,SF,22,WAS,72,31,1653,210,470,0.447,100,291,0.344,110,179,0.615,0.553,51,59,0.864,51,135,186,77,32,22,46,84,571
306,Maxi Kleber,PF,30,DAL,59,21,1450,141,354,0.398,83,255,0.325,58,99,0.586,0.516,46,65,0.708,70,280,350,68,30,58,47,137,411
307,Brandon Knight,PG,30,DAL,5,0,65,10,25,0.4,4,17,0.235,6,8,0.75,0.48,8,8,1,0,8,8,8,1,0,4,5,32
308,Nathan Knight,PF,24,MIN,36,2,251,38,76,0.5,3,10,0.3,35,66,0.53,0.52,42,57,0.737,30,47,77,19,7,8,17,38,121
309,Kevin Knox,SF,22,TOT,28,0,219,31,82,0.378,15,51,0.294,16,31,0.516,0.47,15,20,0.75,13,29,42,10,4,2,7,18,92
309,Kevin Knox,SF,22,NYK,13,0,111,15,40,0.375,10,28,0.357,5,12,0.417,0.5,7,10,0.7,8,14,22,3,2,1,5,5,47
309,Kevin Knox,SF,22,ATL,15,0,108,16,42,0.381,5,23,0.217,11,19,0.579,0.44,8,10,0.8,5,15,20,7,2,1,2,13,45
310,John Konchar,SG,25,MEM,68,6,1212,125,244,0.512,49,118,0.415,76,126,0.603,0.613,25,44,0.568,76,231,307,93,43,21,26,83,324
311,Furkan Korkmaz,SG,24,PHI,63,19,1366,180,457,0.394,76,257,0.296,104,200,0.52,0.477,64,80,0.8,20,151,171,123,32,8,46,56,500
312,Luke Kornet,C,26,TOT,11,0,59,6,17,0.353,0,3,0,6,14,0.429,0.353,2,4,0.5,8,7,15,4,2,1,0,5,14
312,Luke Kornet,C,26,CLE,2,0,15,1,5,0.2,0,1,0,1,4,0.25,0.2,2,3,0.667,2,1,3,1,0,1,0,1,4
312,Luke Kornet,C,26,MIL,1,0,3,0,1,0,0,0,,0,1,0,0,0,0,,1,0,1,0,0,0,0,1,0
312,Luke Kornet,C,26,BOS,8,0,41,5,11,0.455,0,2,0,5,9,0.556,0.455,0,1,0,5,6,11,3,2,0,0,3,10
313,Vit Krejci,SG,21,OKC,25,3,514,45,109,0.413,28,73,0.384,17,36,0.472,0.541,16,19,0.842,14,60,74,38,14,5,22,49,134
314,Arnoldas Kulboka,SF,24,CHO,1,0,3,0,0,,0,0,,0,0,,,0,0,,0,0,0,0,0,0,0,0,0
315,Jonathan Kuminga,SF,19,GSW,66,12,1095,215,427,0.504,43,140,0.307,172,287,0.599,0.554,120,176,0.682,50,166,216,56,27,20,70,134,593
316,Kyle Kuzma,PF,26,WAS,66,66,2204,423,936,0.452,128,375,0.341,295,561,0.526,0.52,156,219,0.712,70,491,561,233,42,57,169,128,1130
317,Anthony Lamb,SF,24,SAS,2,0,8,0,2,0,0,2,0,0,0,,0,0,0,,0,1,1,2,0,0,0,0,0
318,Jeremy Lamb,SF-SG,29,TOT,52,0,858,122,321,0.38,51,156,0.327,71,165,0.43,0.46,84,101,0.832,25,118,143,72,28,21,31,54,379
318,Jeremy Lamb,SF,29,IND,39,0,613,85,228,0.373,39,117,0.333,46,111,0.414,0.458,67,80,0.838,15,79,94,51,23,14,24,44,276
318,Jeremy Lamb,SG,29,SAC,13,0,245,37,93,0.398,12,39,0.308,25,54,0.463,0.462,17,21,0.81,10,39,49,21,5,7,7,10,103
319,Jock Landale,C,26,SAS,51,1,550,98,192,0.51,28,83,0.337,70,109,0.642,0.583,31,37,0.838,58,66,124,43,10,14,31,50,255
320,Romeo Langford,SG,22,TOT,45,5,744,82,188,0.436,29,84,0.345,53,104,0.51,0.513,21,38,0.553,30,75,105,19,21,16,16,46,214
320,Romeo Langford,SG,22,BOS,44,5,728,79,184,0.429,29,83,0.349,50,101,0.495,0.508,20,34,0.588,30,74,104,19,21,16,16,46,207
320,Romeo Langford,SG,22,SAS,1,0,16,3,4,0.75,0,1,0,3,3,1,0.75,1,4,0.25,0,1,1,0,0,0,0,0,7
321,Zach LaVine,SF,26,CHI,65,65,2271,554,1162,0.477,183,466,0.393,371,696,0.533,0.556,314,369,0.851,22,280,302,292,41,22,168,116,1605
322,Jake Layman,SF,27,MIN,33,1,214,27,70,0.386,7,34,0.206,20,36,0.556,0.436,10,14,0.714,6,27,33,9,6,5,10,12,71
323,Damion Lee,SG,29,GSW,59,4,1180,158,359,0.44,62,181,0.343,96,178,0.539,0.526,61,70,0.871,24,165,189,58,38,5,36,91,439
324,Saben Lee,PG,22,DET,35,0,554,63,166,0.38,14,59,0.237,49,107,0.458,0.422,46,58,0.793,15,66,81,95,33,11,28,39,186
325,Alex Len,C,28,SAC,39,10,620,94,176,0.534,6,21,0.286,88,155,0.568,0.551,41,63,0.651,52,109,161,45,13,25,43,100,235
326,Caris LeVert,SG,27,TOT,54,45,1649,361,815,0.443,80,244,0.328,281,571,0.492,0.492,133,177,0.751,42,161,203,227,48,22,101,121,935
326,Caris LeVert,SG,27,IND,39,39,1214,278,622,0.447,61,189,0.323,217,433,0.501,0.496,111,146,0.76,30,120,150,173,35,18,75,91,728
326,Caris LeVert,SG,27,CLE,15,6,435,83,193,0.43,19,55,0.345,64,138,0.464,0.479,22,31,0.71,12,41,53,54,13,4,26,30,207
327,Kira Lewis Jr.,PG,20,NOP,24,0,341,59,146,0.404,13,58,0.224,46,88,0.523,0.449,10,12,0.833,9,30,39,49,11,1,26,17,141
328,Scottie Lewis,SG,21,CHO,2,0,7,0,0,,0,0,,0,0,,,1,2,0.5,0,0,0,1,1,0,0,0,1
329,Damian Lillard,PG,31,POR,29,29,1056,222,552,0.402,92,284,0.324,130,268,0.485,0.486,159,181,0.878,13,107,120,212,17,11,83,37,695
330,Nassir Little,SF,21,POR,42,23,1088,145,315,0.46,51,154,0.331,94,161,0.584,0.541,69,94,0.734,58,178,236,54,25,36,40,82,410
331,Isaiah Livers,SF,23,DET,15,1,280,31,68,0.456,22,51,0.431,9,17,0.529,0.618,5,6,0.833,11,34,45,16,8,6,11,31,89
332,Kevon Looney,C,25,GSW,78,76,1675,201,352,0.571,0,1,0,201,351,0.573,0.571,75,125,0.6,203,375,578,159,48,52,65,210,477
333,Brook Lopez,C,33,MIL,9,7,202,32,77,0.416,12,37,0.324,20,40,0.5,0.494,11,14,0.786,12,20,32,6,4,10,10,27,87
334,Robin Lopez,C,33,ORL,32,9,544,102,181,0.564,2,5,0.4,100,176,0.568,0.569,25,45,0.556,64,51,115,48,1,18,42,61,231
335,Didi Louzada,SG-SF,22,TOT,4,0,35,3,11,0.273,2,9,0.222,1,2,0.5,0.364,0,0,,4,1,5,3,1,1,0,3,8
335,Didi Louzada,SF,22,NOP,2,0,7,0,3,0,0,3,0,0,0,,0,0,0,,2,0,2,1,0,0,0,0,0
335,Didi Louzada,SG,22,POR,2,0,28,3,8,0.375,2,6,0.333,1,2,0.5,0.5,0,0,,2,1,3,2,1,1,0,3,8
336,Kevin Love,PF,33,CLE,70,4,1583,303,716,0.423,171,446,0.383,132,270,0.489,0.543,159,188,0.846,79,420,499,152,25,17,92,95,936
337,Kyle Lowry,PG,35,MIA,61,61,2067,265,609,0.435,140,375,0.373,125,234,0.534,0.55,142,166,0.855,31,240,271,461,64,17,163,168,812
338,Timothé Luwawu-Cabarrot,SF,26,ATL,49,17,641,71,178,0.399,43,116,0.371,28,62,0.452,0.52,35,40,0.875,15,62,77,37,18,6,19,71,220
339,Trey Lyles,PF,26,TOT,71,19,1458,247,531,0.465,65,200,0.325,182,331,0.55,0.526,188,234,0.803,87,272,359,86,27,32,69,117,747
339,Trey Lyles,PF,26,DET,51,3,990,175,384,0.456,44,146,0.301,131,238,0.55,0.513,138,176,0.784,60,184,244,58,22,26,54,91,532
339,Trey Lyles,PF,26,SAC,20,16,468,72,147,0.49,21,54,0.389,51,93,0.548,0.561,50,58,0.862,27,88,115,28,5,6,15,26,215
340,Théo Maledon,PG,20,OKC,50,6,881,116,308,0.377,43,147,0.293,73,161,0.453,0.446,77,98,0.786,20,107,127,106,30,11,63,64,352
341,Sandro Mamukelashvili,PF,22,MIL,38,2,354,45,94,0.479,19,45,0.422,26,49,0.531,0.58,12,16,0.75,32,37,69,18,7,9,11,25,121
342,Terance Mann,SF,25,LAC,77,32,2222,318,658,0.483,72,200,0.36,246,458,0.537,0.538,124,159,0.78,101,311,412,199,55,18,80,172,832
343,Tre Mann,PG,20,OKC,60,26,1367,231,588,0.393,98,272,0.36,133,316,0.421,0.476,65,82,0.793,25,146,171,91,47,12,71,102,625
344,Boban Marjanović,C,33,DAL,21,0,108,37,61,0.607,1,3,0.333,36,58,0.621,0.615,11,20,0.55,7,24,31,2,0,3,11,20,86
345,Lauri Markkanen,PF,24,CLE,57,57,1758,286,650,0.44,120,349,0.344,166,301,0.551,0.532,127,148,0.858,58,265,323,78,45,28,51,116,819
346,Naji Marshall,SF,24,NOP,50,3,646,96,238,0.403,21,99,0.212,75,139,0.54,0.447,63,81,0.778,34,97,131,51,31,6,38,60,276
347,Caleb Martin,SF,26,MIA,57,10,1293,199,389,0.512,60,145,0.414,139,244,0.57,0.589,69,90,0.767,69,151,220,62,56,26,47,99,527
348,Cody Martin,SF,26,CHO,67,11,1764,192,405,0.474,58,151,0.384,134,254,0.528,0.546,72,104,0.692,77,194,271,170,82,30,59,113,514
349,Kelan Martin,SF,26,TOT,30,1,450,70,171,0.409,22,75,0.293,48,96,0.5,0.474,9,13,0.692,17,38,55,21,13,9,14,36,171
349,Kelan Martin,SF,26,IND,27,1,444,70,168,0.417,22,74,0.297,48,94,0.511,0.482,9,13,0.692,16,37,53,21,13,9,14,36,171
349,Kelan Martin,SF,26,BOS,3,0,6,0,3,0,0,1,0,0,2,0,0,0,0,,1,1,2,0,0,0,0,0,0
350,Kenyon Martin Jr.,SF,21,HOU,75,2,1569,266,498,0.534,56,154,0.364,210,344,0.61,0.59,75,118,0.636,79,211,290,96,33,37,58,103,663
351,Garrison Mathews,SG,25,HOU,61,29,1604,175,435,0.402,132,363,0.364,43,72,0.597,0.554,134,167,0.802,31,143,174,60,54,21,38,159,616
352,Dakota Mathias,SG,26,MEM,6,0,16,2,6,0.333,2,6,0.333,0,0,,0.5,0,0,,0,2,2,1,1,0,0,1,6
353,Wesley Matthews,SG,35,MIL,45,10,913,78,202,0.386,49,145,0.338,29,57,0.509,0.507,15,21,0.714,29,58,87,33,22,7,16,79,220
354,Tyrese Maxey,PG,21,PHI,70,69,2492,447,931,0.48,116,279,0.416,331,652,0.508,0.542,195,227,0.859,26,205,231,299,50,30,78,145,1205
355,Skylar Mays,SG,24,ATL,26,5,216,32,64,0.5,8,25,0.32,24,39,0.615,0.563,8,9,0.889,5,20,25,17,7,0,10,9,80
356,Miles McBride,PG,21,NYK,37,2,336,27,95,0.284,13,58,0.224,14,37,0.378,0.353,8,12,0.667,4,36,40,40,13,1,5,42,75
357,Mac McClung,PG,23,CHI,1,0,3,1,1,1,0,0,,1,1,1,1,0,0,,0,0,0,0,0,0,1,0,2
358,CJ McCollum,SG,30,TOT,57,57,2014,504,1089,0.463,171,441,0.388,333,648,0.514,0.541,110,155,0.71,51,205,256,294,60,22,119,114,1289
358,CJ McCollum,SG,30,POR,36,36,1267,290,665,0.436,111,289,0.384,179,376,0.476,0.52,48,68,0.706,34,119,153,163,36,21,70,77,739
358,CJ McCollum,SG,30,NOP,21,21,747,214,424,0.505,60,152,0.395,154,272,0.566,0.575,62,87,0.713,17,86,103,131,24,1,49,37,550
359,T.J. McConnell,PG,29,IND,24,6,581,91,181,0.503,7,25,0.28,84,156,0.538,0.522,12,15,0.8,19,61,80,115,25,9,28,43,201
360,Jaden McDaniels,PF,21,MIN,67,31,1749,248,540,0.459,77,246,0.313,171,294,0.582,0.531,56,70,0.8,76,211,287,77,51,52,73,220,629
361,Jalen McDaniels,SF,24,CHO,51,2,822,106,228,0.465,35,98,0.357,71,130,0.546,0.542,49,68,0.721,34,121,155,49,22,18,35,88,296
362,Doug McDermott,PF,30,SAS,51,51,1223,215,465,0.462,108,256,0.422,107,209,0.512,0.578,40,51,0.784,18,97,115,64,13,6,43,79,578
363,JaVale McGee,C,34,PHO,69,14,1078,271,425,0.638,2,8,0.25,269,417,0.645,0.64,96,135,0.711,150,308,458,39,20,77,89,170,640
364,Cameron McGriff,SF,24,POR,3,0,46,5,14,0.357,2,6,0.333,3,8,0.375,0.429,2,2,1,6,9,15,3,0,1,0,7,14
365,Rodney McGruder,SG,30,DET,48,2,680,82,196,0.418,51,132,0.386,31,64,0.484,0.548,14,20,0.7,29,69,98,43,19,5,21,50,229
366,Alfonzo McKinnie,SF,29,CHI,17,3,206,24,61,0.393,9,27,0.333,15,34,0.441,0.467,2,8,0.25,13,20,33,5,2,3,7,26,59
367,JaQuori McLaughlin,PG,24,DAL,4,0,11,0,2,0,0,1,0,0,1,0,0,0,0,,0,0,0,2,0,0,0,1,0
368,Jordan McLaughlin,PG,25,MIN,58,3,827,80,187,0.428,22,76,0.289,58,111,0.523,0.487,27,37,0.73,21,67,88,169,53,8,34,47,209
369,Ben McLemore,SG,28,POR,59,6,1153,192,490,0.392,136,380,0.358,56,110,0.509,0.531,63,76,0.829,12,81,93,49,31,10,47,94,583
370,De'Anthony Melton,SG,23,MEM,69,14,1557,266,656,0.405,131,349,0.375,135,307,0.44,0.505,80,108,0.741,60,250,310,179,102,35,105,120,743
371,Sam Merrill,SG,25,MEM,6,0,58,8,24,0.333,7,23,0.304,1,1,1,0.479,2,4,0.5,1,6,7,4,0,0,2,3,25
372,Chimezie Metu,C,24,SAC,56,20,1178,189,422,0.448,53,177,0.299,136,245,0.555,0.511,66,85,0.776,33,277,310,57,45,30,57,87,497
373,Khris Middleton,SF,30,MIL,62,62,2009,426,959,0.444,153,405,0.378,273,554,0.493,0.524,253,284,0.891,40,299,339,334,69,17,180,148,1258